NO ./assets/textures/temple_textures/temple1.xpm
SO ./assets/textures/temple_textures/temple1.xpm
WE ./assets/textures/temple_textures/temple3.xpm
EA ./assets/textures/temple_textures/temple4.xpm

F 50,50,50
C 90,90,90

111111111
1000000001
1000000001
1000000001
1000000001
111111111111111111111111111111111111111111111
100000000000000000001000000000000001111100001
1100000000000000000001000000000000011  11111111111111
1111111111111111111111111111111000011       11110000111
100000000000000000000000000000000001        100000000011
100000000000000000000000000000000001        110000000011
111111111111111111110111111111111111        111100000001
100100010001000100010010000000000001        111111111111
100001000100010001000010000010000011
1001000100010001000100100000111111111111
10000000000000000000001000001000000000001
100100010001000100010010000010000000000001
10000000000000000000001000001000000000111
111111111111111111111111111111111111111

