NO ./textures/tile174.png
SO ./textures/tile193.png
WE ./textures/tile232.png
EA ./textures/tile193.png



F 72, 50, 60
C 9, 53, 74

11111111111111
10000000000001
10000000000111
10000E000001
100000000001
100000000001
100000000001
111111111111
