NO /home/asalo/Code/enduserrr/cub3D/textures/north.png
SO /home/asalo/Code/enduserrr/cub3D/textures/south.png
WE /home/asalo/Code/enduserrr/cub3D/textures/west.png
EA /home/asalo/Code/enduserrr/cub3D/textures/east.png

F 50,50,40
C 90,90,80

1111111111     1111111111    1111
1000000001     1000000001    10001
1000000000111110000000001    10001
1000000000000000000000001    11111
1000000000111110000000001
1000000001     1000000001    111111
100000001       1000N0001    100001
11111111         11111111    11111
