NO /home/asalo/Code/enduserrr/cub3D/textures/1.png
SO /home/asalo/Code/enduserrr/cub3D/textures/4.png
WE /home/asalo/Code/enduserrr/cub3D/textures/2.png
EA /home/asalo/Code/enduserrr/cub3D/textures/3.png

F 0, 135, 206
C 255, 87, 51

1111111111     1111111111    1111
1000000001     1000000001    10001
1000000000111110000000001    10001
1000000000000000000000001    11111
1000000000111110000000001
1000000001     1000000001    111111
100000001       1000S0001    100001
11111111         11111111    11111
