NO ./assets/textures/temple_textures/temple1.xpm
SO ./assets/textures/temple_textures/temple1.xpm
WE ./assets/textures/temple_textures/temple3.xpm
EA ./assets/textures/temple_textures/temple4.xpm

F 50,50,50
C 90,90,90

1111111111     1111111111    11111
1000000001     1000000001    10001
1000000000111110000000001    10001
1000000000000000000000001    11111
1000000000111110000000001
1000000001     1000000001    11111
100000001       100000001    10001
11111111         11111111    11111
