NO ./textures/1.png
SO ./textures/2.png
EA ./textures/3.png
WE ./textures/4.png

F 204, 204, 204
C 153, 204, 255

1  11111111      11111111111
  100001001      1000010001
 1000000011111111100000001
10000000000000000000000001
 10000S00111111111000000001
  100000001       1000000001
   100001001       1000000001
    1111 1111       1111111111
