WE ./textures/2.png
EA ./textures/3.png
SO ./textures/4.png
NO ./textures/1.png


F 57, 135, 94
C 215, 180, 166

1  111111111      111111111
  100000001      1000010001
 1000000011111111100000001
1000000000000000000000001
 10000S00111111111000000001
  100000001       1000000001
   100001001       1000000001
    1111 1111       111111111


