WE ./textures/2.png
EA ./textures/3.png
SO ./textures/4.png
NO ./textures/1.png

F 57, 65, 94
C 255, 180, 166

1111111111111111111111111111111111111111111111111111111111111111111111111111111111111111
1000000000000000000000000000000000000000000000000000000000000000000000000000000000000001
1111111111100000000000000000000000000111000000000000000000000000000000000000000000000011
1000000000000000000000000000000000000000000000000000000000000000000000000000000000000001
1111111111100000000000000000000000000111000000000000000000000000000000000000000000000011
1000000000000000000000000000000000000000000000000000000000000000000000000000000000000001
1111111111100000000000000000000000000111000000000000000000000000000000000000000000000011
1000000000000000000000000000000000000000000000000000000000000000000000000000000000000001
1111111111100000000000000000000000000111000000000000000000000000000000000000000000000011
1000000000000000000000000000000000000000000000000000000000000000000000000000000000000001
1111111111100000000000000000000000000111000000000000000000000000000000000000000000000011
1000000000000000000000000000000000000000000000000000000000001111100000000000000000000001
11111111111000000000000000000000000001110000000000000000000010S0100000000000000000000011
1000000000000000000000000000000000000000000000000000000011111000100000000000000000000001
1111111111100000000000000000000000000111000000000000000000000000011111110000000000011      
1000000000000000000000000000000000000000000000000000000000000000000000000000000000000001
1111111111100000000000000000000000000111000000000000000000000000000000000000000000000011
1111111111111111111111111111111111111111111111111111111111111111111111111111111111111111
