NO /home/eleppala/Documents/projects/3cube/textures/east.png
SO /home/eleppala/Documents/projects/3cube/textures/west.png
WE /home/eleppala/Documents/projects/3cube/textures/north.png
EA /home/eleppala/Documents/projects/3cube/textures/south.png


F 0, 0, 128
C 249, 0, 0

111111111111
100000000001
100000000001
100000000001
100000000001
1000N0000001
100000000011
111111111111
