NO ./textures/1.png
SO ./textures/2.png
EA ./textures/3.png
WE ./textures/4.png
F 204,204,204
C 153,204,255
111111111       11111111111
 100001001      10000100001
  10000000111111111000000001
   10000000000000000000000001
  10000S00111111111000000001
 100000001       1000000001
111111111       1111111111
