NO ./textures/tile174.png
SO ./textures/tile193.png
WE ./textures/tile232.png
EA ./textures/tile175.png


F 60, 60, 60
C 50, 50, 50

11111
10001
10E11
111 1
