NO ./textures/tile174.png
SO ./textures/tile193.png
WE ./textures/tile232.png
EA ./textures/tile175.png


F 60, 60, 60
C 50, 50, 50

1111111
1000001
1001E11
1001
1111
