NO ./textures/tile174.png
SO ./textures/tile193.png
WE ./textures/tile232.png
EA ./textures/tile175.png


F 60, 60, 60
C 50, 50, 50

11111111111
1         1
11111 11101
1001 W 1001
1001   1001
1001   1001
10011111001
10000000001
11111111111
