NO ./assets/textures/temple_textures/temple1.xpm
SO ./assets/textures/temple_textures/temple1.xpm
WE ./assets/textures/temple_textures/temple3.xpm
EA ./assets/textures/temple_textures/temple4.xpm

F 50,50,50
C 90,90,90

111111111
1000000001
1000000001
1000000001
1000000001
111111111111111111111111111111111111
100000000000000000001000000000000001
100000000000000000001000000000000001
111111111111111111111111111111100001
100000000000000000000000000000000001
100000000000000000000000000000000001
111111111111111111110111111111111111
100100010001000100010010000000000001
100001000100010001000010000010000001
100100010001000100010010000011111111
100000000000000000000010000010000001
100100010001000100010010000010000001
100000000000000000000010000010000001
111111111111111111111110000010000001
100000000000000000000000000010000001
10000000000000000000000000001000N001
111111111111111111111111111111111111
