

SO ./textures/tile193.png
NO ./textures/tile174.png
WE ./textures/tile232.png
EA ./textures/tile193.png

F 50, 50, 60
C 44, 44, 74

111111111111
100000000001
100000000001111
100011111110001
10001  E  10001
10001     10001
100011111110001
111111111111111
