

SO ./textures/tile193.png
NO ./textures/tile174.png
WE ./textures/tile232.png
EA ./textures/tile193.png

F 50, 50, 60
C 44, 44, 74

1
100000000001
100000000001
10000E000001
100000000001
100000000001
100000000001
111111111111
