WE ./textures/2.png
EA ./textures/3.png
SO ./textures/4.png
NO ./textures/1.png

F 1, 70, 22
C 2, 160, 155
F 1, 70, 22

111111111
1000000001
1000000001
1000000001
1000000001
111111111111111111111111111111111111111111111
100000000000000000001000000000000001111100001
11000000000000000001000000000000011  1111111111111111
1111111111111111111111111111111000011       11110000111
100000000000000000000000000000000001        100000000011
100000000000000000000000000000000001        110000000011
111111111111111111110111111111111111        111100000001
100100010001000100010010000000000001        111111111111
100001000100010001000010000010000011
1001000100010001000100E00000111111111111
10000000000000000000001000001000000000001
100100010001000100010010000010000000000001
10000000000000000000001000001000000000111
111111111111111111111111111111111111111

