WE ./textures/2.png
EA ./textures/3.png
SO ./textures/4.png
NO ./textures/1.png
WE ./textures/2.png
EA ./textures/3.png
SO ./textures/4.png
NO ./textures/1.png

F 11, 70, 92
C 255, 180, 166

   1111111111     1111111111
  100000001      1000000001
 1000000011111111100000001
10000000000000000000000001
 10000S00111111111000000001
  100000001       1000000001
   100000001       1000000001
    111111111       1111111111

