NO ./textures/1.png
SO ./textures/4.png
WE ./textures/2.png
EA ./textures/3.png

F 0, 135, 206
C 255, 87, 51

1111111111     1111111111    1111
1000000001     1000000001    10001
1000000000111110000000001    10001
10000000N0000000000000W01    11111
1000000000111110000000001
1000000001     1000000001    111111
100000001       100000001    100001
11111111         11111111    11111
