WE ./textures/2.png
EA ./textures/3.png
SO ./textures/4.png
NO ./textures/1.png
WE ./textures/2.png
EA ./textures/3.png
SO ./textures/4.png
NO ./textures/1.png

F 11, 70, 92
C 255, 180, 166

1111111111111111111111111111111111
1000000001     1000000001    10001
1000000000111110000000001    10001
100000000000000000000000111111111
10000S0000111110000000001
1000000001     10000000011111111111
100000001       100000001    100001
11111111111111111111111111111111111
