NO ./textures/tile174.png
SO ./textures/tile193.png
WE ./textures/tile232.png
EA ./textures/tile175.png


F 72, 60, 50
C 9, 53, 74

111111111111
10S000000001
100001000001
100001000001
100001000101
100001111101
100000000001
111111111111
