NO ./textures//tile174.png
SO ./textures/tile193.png
WE ./textures/tile232.png
EA ./textures/tile175.png


F 0, 135, 206
C 255, 87, 51

111111111111
100001000001
100000000001
10000N000001
100000000001
100000000001
100000000001
111111111111
