SO ./textures/1.png
F 204,204,204
WE ./textures/2.png
NO ./textures/3.png
C 153,204,255
EA ./textures/4.png

11111111111111111111111111111
10000000000000001000000000001
10000000000000000000000000001
10000000000000001000000000001
10000000000000001111111111111
10000000000000000000000000001
10000000000000000000000000001
10111111111110100000000000001
10100010001010100000000000001
10001000100010100000000000001
11111111111110111111111111111
10000000000000000000000000001
10000000000000000000000000001
11111110111111111111111111101
10000000001000000000000000001
10000000001000000000001000001
10000000001000000000001000001
10000000000000000000001110111
10000000001000000000001000001
10000000001000000000001000001
1000000000100000000000100N001
11111111111111111111111111111
