NO ./textures/tile174.png
SO ./textures/tile193.png
WE ./textures/tile232.png
EA ./textures/tile175.png


F 60, 60, 60
C 50, 50, 50

     111111111   
11111100000001      1111111111
10000000000E000000000000000001
11111111111111      1111111011
                              
111111111111111111111111111111                              