NO ./textures/tile174.png
SO ./textures/tile193.png
WE ./textures/tile232.png
EA ./textures/tile175.png


F 60, 60,
C 50, 50, 50

     111111111
11111100000001
10000000000E01
11111111111111
