WE ./textures/2.png
EA ./textures/3.png
SO ./textures/4.png
NO ./textures/1.png
WE ./textures/2.png
EA ./textures/3.png
SO ./textures/4.png
NO ./textures/1.png

F 11, 70, 1
C 255, 180, 166

   111111111      11111 1111
  100000001      1000001001
 1000000011111111100000001
10000000000000000000000001
 10000S00111111110000000001
  100000001       1000000001
   100001001       1000000001
    1111 1111       1111111111

