SO ./textures/tile193.png
NO ./textures/tile174.png
WE ./textures/tile232.png
EA ./textures/tile193.png

F 50, 50, 60
C 44, 44, 74

 111111111111  111
100000000001   1W1
100001100001   111
100010010001
 1000110001
100000000001
100000000001
111111111111
